new_admin_session	GET	/admin/sign_in(.:format)	admin/sessions#new
admin_session	POST	/admin/sign_in(.:format)	admin/sessions#create
destroy_admin_session	DELETE	/admin/sign_out(.:format)	admin/sessions#destroy
new_employee_session	GET	/employees/sign_in(.:format)	public/sessions#new
employee_session	POST	/employees/sign_in(.:format)	public/sessions#create
destroy_employee_session	DELETE	/employees/sign_out(.:format)	public/sessions#destroy
cancel_employee_registration	GET	/employees/cancel(.:format)	public/registrations#cancel
new_employee_registration	GET	/employees/sign_up(.:format)	public/registrations#new
edit_employee_registration	GET	/employees/edit(.:format)	public/registrations#edit
employee_registration	PATCH	/employees(.:format)	public/registrations#update
	PUT	/employees(.:format)	public/registrations#update
	DELETE	/employees(.:format)	public/registrations#destroy
	POST	/employees(.:format)	public/registrations#create
employees_guest_sign_in	POST	/employees/guest_sign_in(.:format)	public/sessions#guest_sign_in
root	GET	)	public/homes#top
employees_search	GET	/employees_search(.:format)	public/searches#employees_search
articles_search	GET	/articles_search(.:format)	public/searches#articles_search
groups_search	GET	/groups_search(.:format)	public/searches#groups_search
department_search	GET	/department_search(.:format)	public/searches#department_search
tag_search	GET	/tag_search(.:format)	public/searches#tag_search
destroy_all_activities	DELETE	/activities/destroy_all(.:format)	public/activities#destroy_all
activities	GET	/activities(.:format)	public/activities#index
employees	GET	/employees(.:format)	public/employees#index
edit_employee	GET	/employees/:id/edit(.:format)	public/employees#edit
employee	GET	/employees/:id(.:format)	public/employees#show
	PATCH	/employees/:id(.:format)	public/employees#update
	PUT	/employees/:id(.:format)	public/employees#update
article_favorites	DELETE	/articles/:article_id/favorites(.:format)	public/favorites#destroy
	POST	/articles/:article_id/favorites(.:format)	public/favorites#create
article_comments	POST	/articles/:article_id/comments(.:format)	public/comments#create
article_comment	DELETE	/articles/:article_id/comments/:id(.:format)	public/comments#destroy
articles	GET	/articles(.:format)	public/articles#index
	POST	/articles(.:format)	public/articles#create
new_article	GET	/articles/new(.:format)	public/articles#new
edit_article	GET	/articles/:id/edit(.:format)	public/articles#edit
article	GET	/articles/:id(.:format)	public/articles#show
	PATCH	/articles/:id(.:format)	public/articles#update
	PUT	/articles/:id(.:format)	public/articles#update
	DELETE	/articles/:id(.:format)	public/articles#destroy
group_group_members	DELETE	/groups/:group_id/group_members(.:format)	public/group_members#destroy
	POST	/groups/:group_id/group_members(.:format)	public/group_members#create
group_notices	POST	/groups/:group_id/notices(.:format)	public/notices#create
new_group_notice	GET	/groups/:group_id/notices/new(.:format)	public/notices#new
group_notice	GET	/groups/:group_id/notices/:id(.:format)	public/notices#show
	DELETE	/groups/:group_id/notices/:id(.:format)	public/notices#destroy
groups	GET	/groups(.:format)	public/groups#index
	POST	/groups(.:format)	public/groups#create
new_group	GET	/groups/new(.:format)	public/groups#new
edit_group	GET	/groups/:id/edit(.:format)	public/groups#edit
group	GET	/groups/:id(.:format)	public/groups#show
	PATCH	/groups/:id(.:format)	public/groups#update
	PUT	/groups/:id(.:format)	public/groups#update
	DELETE	/groups/:id(.:format)	public/groups#destroy
admin_employees_search	GET	/admin/employees_search(.:format)	admin/searches#employees_search
admin_articles_search	GET	/admin/articles_search(.:format)	admin/searches#articles_search
admin_department_search	GET	/admin/department_search(.:format)	admin/searches#department_search
admin_tag_search	GET	/admin/tag_search(.:format)	admin/searches#tag_search
admin_employees	GET	/admin/employees(.:format)	admin/employees#index
edit_admin_employee	GET	/admin/employees/:id/edit(.:format)	admin/employees#edit
admin_employee	GET	/admin/employees/:id(.:format)	admin/employees#show
	PATCH	/admin/employees/:id(.:format)	admin/employees#update
	PUT	/admin/employees/:id(.:format)	admin/employees#update
admin_article_comment	DELETE	/admin/articles/:article_id/comments/:id(.:format)	admin/comments#destroy
admin_articles	GET	/admin/articles(.:format)	admin/articles#index
admin_article	GET	/admin/articles/:id(.:format)	admin/articles#show
admin_departments	GET	/admin/departments(.:format)	admin/departments#index
	POST	/admin/departments(.:format)	admin/departments#create
edit_admin_department	GET	/admin/departments/:id/edit(.:format)	admin/departments#edit
admin_department	PATCH	/admin/departments/:id(.:format)	admin/departments#update
	PUT	/admin/departments/:id(.:format)	admin/departments#update
	DELETE	/admin/departments/:id(.:format)	admin/departments#destroy
rails_postmark_inbound_emails	POST	/rails/action_mailbox/postmark/inbound_emails(.:format)	action_mailbox/ingresses/postmark/inbound_emails#create
rails_relay_inbound_emails	POST	/rails/action_mailbox/relay/inbound_emails(.:format)	action_mailbox/ingresses/relay/inbound_emails#create
rails_sendgrid_inbound_emails	POST	/rails/action_mailbox/sendgrid/inbound_emails(.:format)	action_mailbox/ingresses/sendgrid/inbound_emails#create
rails_mandrill_inbound_health_check	GET	/rails/action_mailbox/mandrill/inbound_emails(.:format)	action_mailbox/ingresses/mandrill/inbound_emails#health_check
rails_mandrill_inbound_emails	POST	/rails/action_mailbox/mandrill/inbound_emails(.:format)	action_mailbox/ingresses/mandrill/inbound_emails#create
rails_mailgun_inbound_emails	POST	/rails/action_mailbox/mailgun/inbound_emails/mime(.:format)	action_mailbox/ingresses/mailgun/inbound_emails#create
rails_conductor_inbound_emails	GET	/rails/conductor/action_mailbox/inbound_emails(.:format)	rails/conductor/action_mailbox/inbound_emails#index
	POST	/rails/conductor/action_mailbox/inbound_emails(.:format)	rails/conductor/action_mailbox/inbound_emails#create
new_rails_conductor_inbound_email	GET	/rails/conductor/action_mailbox/inbound_emails/new(.:format)	rails/conductor/action_mailbox/inbound_emails#new
edit_rails_conductor_inbound_email	GET	/rails/conductor/action_mailbox/inbound_emails/:id/edit(.:format)	rails/conductor/action_mailbox/inbound_emails#edit
rails_conductor_inbound_email	GET	/rails/conductor/action_mailbox/inbound_emails/:id(.:format)	rails/conductor/action_mailbox/inbound_emails#show
	PATCH	/rails/conductor/action_mailbox/inbound_emails/:id(.:format)	rails/conductor/action_mailbox/inbound_emails#update
	PUT	/rails/conductor/action_mailbox/inbound_emails/:id(.:format)	rails/conductor/action_mailbox/inbound_emails#update
	DELETE	/rails/conductor/action_mailbox/inbound_emails/:id(.:format)	rails/conductor/action_mailbox/inbound_emails#destroy	new_rails_conductor_inbound_email_source	GET	/rails/conductor/action_mailbox/inbound_emails/sources/new(.:format)	rails/conductor/action_mailbox/inbound_emails/sources#new
rails_conductor_inbound_email_sources	POST	/rails/conductor/action_mailbox/inbound_emails/sources(.:format)	rails/conductor/action_mailbox/inbound_emails/sources#create
rails_conductor_inbound_email_reroute	POST	/rails/conductor/action_mailbox/:inbound_email_id/reroute(.:format)	rails/conductor/action_mailbox/reroutes#create
rails_service_blob	GET	/rails/active_storage/blobs/redirect/:signed_id/*filename(.:format)	active_storage/blobs/redirect#show
rails_service_blob_proxy	GET	/rails/active_storage/blobs/proxy/:signed_id/*filename(.:format)	active_storage/blobs/proxy#show
	GET	/rails/active_storage/blobs/:signed_id/*filename(.:format)	active_storage/blobs/redirect#show
rails_blob_representation	GET	/rails/active_storage/representations/redirect/:signed_blob_id/:variation_key/*filename(.:format)	active_storage/representations/redirect#show
rails_blob_representation_proxy	GET	/rails/active_storage/representations/proxy/:signed_blob_id/:variation_key/*filename(.:format)	active_storage/representations/proxy#show
	GET	/rails/active_storage/representations/:signed_blob_id/:variation_key/*filename(.:format)	active_storage/representations/redirect#show
rails_disk_service	GET	/rails/active_storage/disk/:encoded_key/*filename(.:format)	active_storage/disk#show
update_rails_disk_service	PUT	/rails/active_storage/disk/:encoded_token(.:format)	active_storage/disk#update
rails_direct_uploads	POST	/rails/active_storage/direct_uploads(.:format)	active_storage/direct_uploads#create